***************
*****E    *****
********* *****
********* *****
********* *****
*******   *****
******  *******
*S      *******
***************
***************
